0,0,0,0,0,0,0,0,0,0,4,4,4,4,4,4
0,1,1,1,2,3,3,4,4,4,4,4,4,4,4,4
0,1,1,2,2,3,3,3,4,4,4,4,4,4,4,4
0,0,0,0,2,3,3,3,3,0,4,4,4,4,4,4
1,1,2,0,2,3,3,3,3,0,4,4,4,4,4,4
1,1,2,0,2,3,3,3,3,0,4,4,4,4,4,4
0,0,0,0,2,3,3,3,3,0,4,4,4,4,4,4
2,2,2,2,2,3,3,4,4,0,4,4,4,4,4,4
1,2,2,3,3,3,3,4,4,0,4,4,4,4,4,4
1,1,2,2,3,3,3,4,4,0,4,4,4,4,4,4
1,1,1,2,2,3,3,4,4,0,4,4,4,4,4,4
1,1,1,2,2,2,3,3,3,0,4,4,4,4,4,4